WWWWWWWWWWWWWWWWWWWWWWWWWWWWWWWWWWWWWWWWWWWWWWWWWWWWWWWWWWWWWWWWWWWWWWWWWWWWWWWW
W..............................................................................W
W..............................................................................W
W....................................P..............................2..........W
W..............................................................................W
W..............................................................................W
W..............................................................................W
W..............................................................................W
W..............................................................................W
W..............................................................................W
W...............s..............................................................W
W..............................................................................W
W..............................................................................W
W..............................................................................W
W..............................................................................W
W..............................................................................W
W..............................................................................W
W..............................................................................W
W..............................................................................W
W..............................................................................W
W..............................................................................W
W..............................................................................W
W..............................................................................W
W..............................................................................W
W..............................................................................W
W..............................................................................W
W..............................................................................W
W..............................................................................W
W..............................................................................W
W..............................................................................W
W..............................................................................W
W..............................................................................W
W..............................................................................W
W..............................................................................W
W..............................................................................W
W..............................................................................W
W..............................................................................W
W..............................................................................W
W..............................................................................W
W..............................................................................W
WWWWWWWWWWWWWWWWWWWWWWWWWWWWWWWWWWWWWWWWWWWWWWWWWWWWWWWWWWWWWWWWWWWWWWWWWWWWWWWW